网址：http://www.xp85.com/

游戏秘籍：

GTA系列游戏中自带作弊码已经是一种传统了，R星并不在乎这些可能会影响游戏的平衡，因为他们只想让玩家在游戏中玩的快乐，一些给出的是游戏自带的作弊码列表：

thugs tools - 棍子类武器
professional tools - 枪类武器
nutter tools - 变态武器
precious protection - 加满防弹衣
aspirine - 满血
panzer - 坦克
sea ways - 可以在水里开车
you wont take me alive - 加2星通缉等级
leave me alone - 通缉等级清零
a pleasant day - 好天气
a lovely day - 超好天气
a bit drieg - 阴天
cats and dogs - 雨天
cant see a thing - 雾天
life is passing me by - 时间过得更快
big bang - 附近所有车子爆炸
still like dressing up -切换玩家人物模型
fight fight fight - 街上的NPC互殴
nobody likes me - 攻击市民造成更大伤害
our god given right to bear arms - 街上所有人有武器
on speed - 走的更快
booooooring - 走的更慢
wheels are all ineed - 车子不见，只有轮子
come fly with me - 苍蝇飞来飞去（车会飘）
grip is everything - 车辆有喷汽弹射功能(shift)
chases tat - 2颗星以上显示媒体级别
chicks with guns - 手下变拿M4的MM（前提得做老大）
i cant take it anymore - 自杀
green light - 所有红绿灯变绿
miami traffic - 路上车子开的很快
ah air dresser scar - 路上的车全变成紫色
i want it pain ted black - 路上的车全变成爆炸后的颜色
travel in style - 车子会飞
the last ride - 给你一辆葬礼车
rock and roll car - 给你一辆豪华轿车
rubbish car - 给你一辆垃圾车
get the refast - 给你一辆 SABRE TURBO
better than walking - 给你一辆caddy
look like lance - LANCE皮肤
my son is a lawyer - 律师皮肤
i look like hilary - HILARY SKIN
rock and roll man - 摇滚舞者皮肤
one armed bandit - 强盗皮肤
i dont have the money sonny - MAFIOSI SKIN
loads of little things - 跑车车轮变大(仅INFERNUS、CHEETAH)
hopingirl - 附近的人上你的车
air ship - 快艇会飘起来
foxy little thing - MAFIOSI DAUGHTER SKIN （女儿）
we love our dick - SCOTTISH SKIN （苏格兰人）
get there quickly - 得到快车子
get there very fast indeed - 得到超快车
get there amazingly fast - 得到超超快车
fanny magnet - 女人都会被你吸引
cheats have been cracked - BALDGUY SKIN
certain death - 嘴里叼跟烟
deep fried mars bars - 变胖
programmer - 变瘦

进入游戏，回车键敲一下，输入这些代码再回车键就能获得你想要的东西了。